benchmark,nor2,inv1,buf,zero,one,total
vg2.v,206,167,0,0,0,373
sao2.v,188,126,0,0,0,314
rd73.v,273,153,0,0,0,426
e64.v,583,584,1,0,0,1168
duke2.v,386,316,0,0,0,702
clip.v,297,191,0,0,0,488
apex5.v,767,527,3,3,0,1300
9sym.v,277,182,0,0,0,459
misex3c.v,534,223,0,0,0,757
inc.v,96,36,0,0,0,132
