benchmark,nor2,inv1,buf,zero,one,total
c880.v,309,194,0,0,0,503
c7552.v,1363,706,43,0,0,2112
c6288.v,1870,974,0,0,0,2844
c5315.v,1286,603,13,0,0,1902
c499.v,387,210,0,0,0,597
c432.v,124,94,0,0,0,218
c3540.v,916,463,0,0,0,1379
c2670.v,571,315,85,1,0,972
c1908.v,364,216,0,0,0,580
c1355.v,390,213,0,0,0,603
